205 205 205 205 205 205 205 205 205 205 205 205 205 205 205 205 205 205 205 205 205 205 205 205
205 89 89 89 89 89 89 89 89 89 89 89 89 89 89 89 35 41 0 7 0 8 0 205
205 32 33 34 32 33 34 32 33 34 32 33 34 32 33 34 167 168 169 32 33 34 32 205
205 142 142 206 207 208 142 142 142 143 0 0 141 142 142 170 171 172 173 142 142 142 142 205 
205 0 0 209 210 211 0 0 0 146 0 0 144 0 0 174 175 176 177 0 0 0 0 205
205 0 0 212 213 214 0 0 0 146 0 0 144 0 0 178 179 180 181 0 0 0 0 205
205 103 105 215 216 217 104 103 105 146 254 255 144 104 105 182 183 184 185 104 103 103 103 205
205 0 0 0 0 0 0 0 224 146 0 0 144 0 0 0 218 219 0 0 0 0 0 205
205 0 0 0 0 0 0 0 0 146 0 0 144 0 0 0 220 221 0 0 0 0 0 205
205 0 0 0 0 0 0 0 0 146 0 0 144 0 0 0 222 223 0 0 0 0 0 205
205 0 0 0 0 0 0 0 0 146 0 0 144 0 0 0 0 0 0 0 0 0 0 205
205 148 148 148 148 148 148 148 148 149 0 0 147 148 148 148 148 148 148 148 148 148 148 205
205 0 0 0 0 0 0 0 0 0 0 0 0 0 0 0 0 0 0 0 0 0 0 205
205 0 0 0 0 0 0 0 0 0 0 0 0 0 0 0 0 0 0 0 0 0 0 205
205 150 150 150 150 150 150 150 150 150 150 150 150 150 150 150 150 150 150 150 150 150 150 205
205 205 205 205 205 205 205 205 205 205 205 205 205 205 205 205 205 205 205 205 205 205 205 205