205 205 205 205 205 205 205 205 205 205 205 205 205 205 205 205 205 205 205 205 205 205 205 205 
205 78 81 82 77 78 79 80 81 82 77 78 79 80 81 82 200 198 199 200 201 198 200 205
205 82 77 78 79 80 81 82 77 78 79 80 77 78 79 77 81 82 77 78 79 80 81 205
205 78 79 225 225 225 82 77 78 79 80 81 82 77 78 225 225 80 225 80 77 78 79 205
205 162 160 161 162 163 164 157 157 82 77 78 82 156 157 158 159 160 161 162 163 164 165 205
205 156 157 158 159 160 159 160 165 79 80 81 79 156 157 158 159 160 161 162 163 164 165 205
205 226 227 228 229 230 231 232 233 82 77 78 81 234 235 236 237 226 227 228 229 230 231 205
205 155 156 157 158 159 160 158 230 77 78 79 78 155 156 157 158 159 160 161 162 163 164 205
205 166 155 156 157 158 159 160 162 79 80 81 77 156 157 158 159 160 161 162 163 164 165 205
205 161 162 163 164 165 166 155 157 82 77 78 80 161 162 163 164 155 156 157 158 159 160 205
205 155 156 157 158 159 160 161 164 77 78 79 82 155 156 157 158 159 160 161 162 163 164 205
205 82 77 78 79 80 81 82 77 78 79 80 77 78 79 77 81 82 77 78 79 80 81 205
205 79 80 81 82 77 78 79 80 81 82 77 78 79 80 77 78 79 80 81 82 77 80 205
205 80 81 82 77 78 79 80 81 82 77 78 79 80 81 82 77 78 79 80 77 78 79 205
205 77 78 79 80 81 82 77 78 79 80 81 82 77 78 79 80 81 82 77 78 79 78 205
205 205 205 205 205 205 205 205 205 205 205 205 205 205 205 205 205 205 205 205 205 205 205 205 
