205 205 205 205 205 205 205 205 205 205 205 205 205 205 205 205 205 205 205 205 205 205 205 205
205 205 203 205 205 205 206 207 208 205 205 205 205 205 205 205 0 248 249 250 205 204 205 205
205 205 205 205 205 205 209 210 211 205 205 205 202 205 205 205 170 171 172 173 205 205 205 205
205 251 251 251 251 251 252 213 253 251 251 251 251 251 251 251 174 175 176 177 251 251 251 205
205 93 103 103 103 105 215 216 217 104 103 103 103 103 103 105 178 179 180 181 104 103 103 205
205 107 137 148 148 148 148 148 148 148 148 148 148 148 148 148 244 183 184 245 148 148 136 205
205 107 146 141 142 142 142 142 142 142 142 142 143 0 0 246 247 238 239 0 0 0 144 205
205 107 146 144 145 145 145 145 145 145 145 145 146 0 240 90 91 90 91 90 91 241 144 205
205 107 146 144 145 145 145 145 145 145 145 145 146 0 85 0 0 0 0 0 0 87 144 205
205 107 146 144 145 145 145 145 145 145 145 145 146 0 86 0 7 0 0 0 0 88 144 205
205 107 146 144 145 145 145 145 145 145 145 145 146 0 85 0 0 0 0 8 0 87 144 205
205 107 146 147 148 148 148 148 148 148 148 148 149 0 242 32 33 34 32 33 34 243 144 205
205 107 146 0 0 0 0 0 0 0 0 0 0 0 0 0 0 0 0 0 0 0 144 205
205 102 139 142 142 142 142 142 142 142 143 0 0 141 142 142 142 142 142 142 142 142 138 205
205 1 2 1 2 1 2 1 2 1 2 254 255 1 2 1 2 1 2 1 2 1 2 205
205 205 205 205 205 205 205 205 205 205 205 205 205 205 205 205 205 205 205 205 205 205 205 205