205 205 205 205 205 205 205 205 205 205 205 205 205 205 205 205 205 205 205 205 205 205 205 205
205 205 205 205 205 205 205 205 205 205 205 205 205 205 205 205 205 205 205 205 205 205 205 205
205 205 205 205 205 205 205 205 205 205 205 205 205 205 205 205 205 205 205 205 205 205 205 205
205 205 205 205 205 205 205 205 205 205 205 205 205 205 205 205 251 205 205 251 205 205 205 205
205 157 158 159 160 161 162 163 164 165 166 155 156 157 158 159 160 161 162 157 158 159 160 205
205 165 80 81 82 77 78 79 80 81 82 77 78 79 80 81 82 77 78 79 81 82 77 205
205 166 77 78 79 80 81 82 77 78 79 80 81 82 77 78 79 81 82 77 78 79 80 205
205 163 81 82 77 78 79 80 81 82 77 78 79 80 198 199 200 201 198 199 200 201 77 205
205 161 77 78 79 80 81 82 77 78 79 80 81 82 199 200 201 198 199 200 201 198 78 205
205 159 78 79 80 81 82 77 78 79 80 81 82 77 200 201 198 199 200 201 198 199 79 205
205 158 79 80 81 82 77 78 79 80 81 82 77 78 201 198 199 200 201 198 199 200 80 205
205 160 80 81 82 77 78 79 80 81 82 77 78 79 198 199 200 201 198 199 200 201 81 205
205 163 80 81 82 77 78 79 80 81 82 77 78 79 80 81 82 77 78 79 81 82 77 205
205 166 78 79 80 81 82 77 78 79 80 81 82 77 78 79 80 81 82 77 78 79 80 205 
205 155 156 157 158 159 160 161 162 163 164 82 77 155 156 157 158 159 160 161 162 163 164 205
205 205 205 205 205 205 205 205 205 205 205 205 205 205 205 205 205 205 205 205 205 205 205 205